555555555555555555555555555555
500000000000000000000000000005
500220000220022200220000022005
500200000000000000000000002005
500000110001100001100011000005
500000000000000000000000000005
500000100003000000000001000005
500200000033300003330000002005
500200000003000000000000002005
500000100000000000000001000005
500000100000000000000001000005
500200000030300000300000002005
500200000003000000000000002005
500000100030300000300001000005
500000000000000000000000000005
500000110001100001100011000005
500200000000000000000000002005
500220000220022200220000022005
500000000000000000000000000005
555555555555555555555555555555